NO north_texture

SO south_texture

WE east_texture

EA west_texture

F 220,100,0
C 225,30,0

1111111111
100E011 11
1111111111